m000m0m0mmm0mmm
0mm000m000m0000
00m0mm00mm0m0m0
0m00000mm00m0m0
00mmmm0mm0m00mm
d000mm000mm00ga
m0m0mmmm00000mm
m0m0m0000mmm0m0
000mm0mm0m00000
m0mm00000m0mmm0
m0000mm0000m000
